scenes_stereo/office07.wav	office
scenes_stereo/restaurant01.wav	restaurant
scenes_stereo/supermarket02.wav	supermarket
scenes_stereo/tubestation04.wav	tubestation
scenes_stereo/tube06.wav	tube
scenes_stereo/busystreet04.wav	busystreet
scenes_stereo/quietstreet02.wav	quietstreet
scenes_stereo/park10.wav	park
scenes_stereo/busystreet03.wav	busystreet
scenes_stereo/quietstreet04.wav	quietstreet
scenes_stereo/quietstreet07.wav	quietstreet
scenes_stereo/busystreet06.wav	busystreet
scenes_stereo/restaurant03.wav	restaurant
scenes_stereo/supermarket10.wav	supermarket
scenes_stereo/openairmarket03.wav	openairmarket
scenes_stereo/openairmarket04.wav	openairmarket
scenes_stereo/park08.wav	park
scenes_stereo/bus02.wav	bus
scenes_stereo/tubestation05.wav	tubestation
scenes_stereo/supermarket05.wav	supermarket
scenes_stereo/park09.wav	park
scenes_stereo/tube04.wav	tube
scenes_stereo/bus04.wav	bus
scenes_stereo/bus05.wav	bus
scenes_stereo/tubestation09.wav	tubestation
scenes_stereo/openairmarket02.wav	openairmarket
scenes_stereo/tube08.wav	tube
scenes_stereo/office03.wav	office
scenes_stereo/restaurant08.wav	restaurant
scenes_stereo/office02.wav	office
